11111111111
1000CC11001
1P100000001
1E100000001
111000CCCC1
10000C10001
10000C10001
10000C10001
10000C10001
10000C10001
10000C10001
10000C10001
10000C10001
10000C10001
10000C10001
11111111111