11111111111111
1P0000000011C1
1000E000CCC101
10000011000001
1CC11100000C01
100000C000CC01
11111111111111