11111111111111111
100000PCCCCE11001
10000000000000001
1CCC1100000000101
11111111111101111
11111111111111111