111111111
1PCE01111
1C00C0011
111111111