11111111111
1P1E1C11111
11111111111